#width: 24
#height: 24
111111111111111111111111
100000000000000000000001
100P00000000000000000001
100000000000000E00000001
100000222220000303030001
100000200020000000000001
100000200020000300030001
100000200020000000000001
100000220220000303030001
100000000000000000000001
10000E000000000000000001
100000000000000000000001
10000000000000E000000001
100000000000000000000001
100000000000000000000001
100000000000000000000001
144444444000000000000001
1404000040000000E0000001
140000504000000000000001
140400004000000000000001
140444444000E00000000001
140000000000000000000001
144444444000000000000001
111111111111111111111111
