#width: 24
#height: 24
111111111111111111111111
100000000000000000000001
100P00222200000000E00001
100000002222000000000001
100000000022220000000001
100000000000222200000001
10000E000000000000000001
100000000000000000000001
100033333333000000000001
100000003333333300000001
10000E000000333333330001
100000000000000000000001
100004444444444444400001
100004000000000000400001
1000040004444440E0400001
100004000000000000400001
100004000044444444400001
100004000040000000000001
100000000040000000000001
1000044444400000000E0001
100000000000000000000001
111111111111111111111111
