#width: 30
#height: 30
1111111111111111111111111111111
1111111111111110111111111111111
1111111111111110111111111111111
1111111111111000001111111111111
1111111111111111101111111111111
1111111111105510001011111111111
1111111111100010151011111111111
1111111110003000100000111111111
1111111110111111111111111111111
11111110001P0000200000001111111
1111111010101111111141101111111
1111101010100000100000100011111
1111101010101110000050421011111
1112031010001010000000001000111
1110101011411010000000011110111
1000101010001010000010031000001
1113111210111013030002001110111
1110301010030010000000000010111
1111101010102010030000111011111
1111100010100040100000000011111
1111111211101010101111121111111
1111111000001010150E00131111111
1111111110040010111110111111111
1111111110500010001000111111111
1111111111004110111011111111111
1111111111100040100011111111111
1111111111111011101111111111111
1111111111111000001111111111111
1111111111111110111111111111111
1111111111111110111111111111111
1111111111111111111111111111111