#width: 10
#height: 10
1111111111
1000000001
1042200001
104P000E01
1022200001
1000000001
1000333001
1000303001
1000000001
1111111111