#width: 24
#height: 24
111111111111111111111111
100000000000000000000001
100000111100000000111001
10000010010000P000101001
100000100100000000101001
100000111100000000101001
100000000000000000101001
100011111111000000101001
100010000001000000101001
100010222201000000111001
100010222201000000000001
100010222201111111111001
100010000001000000000001
100011111111000000000001
100000000000000000000001
100000000000000000000001
133333333330000444444441
130300003330000400000041
130000503330000400000041
130300003330000400000041
133333333330000444444441
100000000000000000000001
133333333333333333333331
111111111111111111111111