#width: 24
#height: 24
111111111111111111111111
100000000000000000000001
100P00000222222222222001
100000000000000000000001
100000000000000E00000001
100303030300000000000001
100030303030000000000001
100303030300000000000001
100030303030000000000001
100000000000000000000001
100000000004444444444441
10000000000400000000E001
100000000004444400000001
100000000444000000044441
10000000E000000000000001
100000000444000000044441
100000000004444400000001
100000000004000000E00001
100000000004444444444441
10000E000000000000000001
100000000000000000000001
111111111111111111111111
